R 1690 1900
NO ./textures/ice_packed0.xpm
SO ./textures/ice_packed1.xpm
EA ./textures/ice_packed3.xpm
WE ./textures/ice_packed2.xpm
S ./textures/Henry (1).xpm
F 200,230,225
C 120,120,255

        1111111111111111111111111
        1000000000110000000000001
        1011000001110000002000001
        1001000000000000000000001
111111111011000001110000000000001
100000000011000001110111111111111
11110111111111010000000010001
11110111111111011101010000001
11000000110101011100000010202
10002000000000001100000010001
10000000000000001101010010001
11000001110101011111011110N0111
11110111 1110101 101111010001
11111111 1111111 111111111111


