R 1920 1080
NO ./textures/the_north_texture.xpm
SO ./textures/the_south_texture.xpm
WE ./textures/the_west_texture.xpm
EA ./textures/the_east_texture.xpm

S ./textures/the_sprite_texture.xpm
F 199,220,227
C 149,226,250

SF ../xpm/library_game/eye.xpm
SD ../xpm/library_game/eye_fermented.xpm
W0 ../xpm/weapon/bow_pulling_0.xpm
W1 ../xpm/weapon/bow_pulling_1.xpm
W2 ../xpm/weapon/bow_pulling_2.xpm
W3 ../xpm/weapon/bow_standby.xpm
DN ../xpm/door/door_wood.xpm
DS ../xpm/door/door_otherside.xpm
DE ../xpm/door/door_wood.xpm
DW ../xpm/door/door_otherside.xpm
LI ../xpm/heart.xpm
LO ../xpm/replay_button.xpm
WI ../xpm/win_game.xpm
11111111
11111311
11111111
 1111111111111111111111111111
11100000000000000000000000001
 1100000000000000000000000001
11100111111111111111111111001
 11001     1111111111111110011111111111
111001     10000000001   1001 100020001
 11001     10000000001   1001 100000001
111001111  10011111001   1001 100200201
 11020011  10011121001   1001 100000001
111001111  10011000001   1001 100000001
 11001     100110N0001   1001 100000001
111001     100111111111111001 111100111
 11001     100000000000000001   110011
111001     100000000000000001    10011
 1100111111111111111111111111111110011
11100000000000000000000000000000000011
 1120000000000000000000000000000000211
11111111111111111111111111111111111111
1